******************************************************************
Maze: 1
File offset: 148C, DS:00FC, table offset: 0000
Size X: 22
Size Y: 11
End: 14BD
Length: 50

    XXXXX
    X   X
    X*  X
  XXX  *XXX
  X  *  * X
XXX X XXX X     XXXXXX
X   X XXX XXXXXXX  ..X
X *  *             ..X
XXXXX XXX  X@XXXX  ..X
    X      XXX  XXXXXX
    XXXXXXXX